

NO ./maps/croissant.png
SO ./maps/croissant.png
WE ./maps/croissant.png
EA ./maps/croissant.png

F 100,100,0  

C 225,30,0


11111111111111111111111111111
10000000001100000000000111111
1011000001110000000000000011111
1001000000000000000000000000001
1111111110110000011100000001111
10000000001100000111011111111111
111101111111110111000000100111
1111011111111101110101001000111
1100000011010101110000001000111
1000000000000000110000001000111
1000000000000000110101001000111
11000001110101011111011110N01
11110111111101011101111010001
11111111111111111111111111111













































