

NO ./maps/croissant.png
SO ./maps/croissant.png
WE ./maps/croissant.png
EA ./maps/croissant.png

F 100,100,0  

C 225,30,0


11111111111111111111111111111
10000000001100000000000111111
10110000011100000000000000111
1001000000000000000000000000111
1111111110110000011100000000111
1000000000110000011101111111111
1111011111111101110000001000111
1111011111111101110101001000111
1100000011010101110000001000111
1000000000000000110000001000111
1000000000000000110101001000111
11000001110101011111011110N01
11110111111101011101111010001
11111111111111111111111111111













































