

NO ./maps/purplestone.png
SO ./maps/mossy.png
WE ./maps/wood.png
EA ./maps/redbrick.png

F 100,100,0

C 225,100,0

111111111111111111111111111
100000000000100000000000001
100000000000100000000000001
111111111111111111113111111
100000000000100000000000001
10000000000020000000N000001
100000000000100000000000001
111111111111111111111111111
