

NO ./maps/croissant.png
SO ./maps/croissant.png
WE ./maps/croissant.png
EA ./maps/croissant.png

F 100,100,0  

C 225,30,0


11111111111111111111111111111
11111111111111000000000000001
11110000111100000000000000001
11100000000000000000000000001
11000000000000000000000000001
1000000000000000000W000000001
10000000000000000000000000001
10000000000000000000000000001
10000000000000000000000000001
10000000000000000000000000001
10000000000000000000000000001
10000000000000000000000000001
10000000000000000000000000001
11111111111111111111111111111













































