NO ./maps/textures/purplestone.png
SO ./maps/textures/mossy.png
WE ./maps/textures/wood.png
EA ./maps/textures/redbrick.png

DO ./maps/textures/door.png
WD ./maps/textures/door_wall.png

S1 ./maps/textures/barrel.png
S2 ./maps/textures/pillar.png
S3 ./maps/textures/greenlight.png

F 100,100,0
C 225,100,0

1111111111111111111
1000000010000000001
10000000D0000000001
1000000010000000001
111D11111111O111111
1000000010000000001
10000000D300S000401
1000000010002000001
1111111111111111111
