NO ./maps/textures/purplestone.png
SO ./maps/textures/mossy.png
WE ./maps/textures/wood.png
EA ./maps/textures/redbrick.png
DO ./maps/textures/door.png
WD ./maps/textures/door_wall.png

F 100,100,0
C 225,100,0

1111111111111111111
1000000010000000001
1000000020000000001
1000000010000000001
1112111111113111111
1000000010000000001
100000002000S000001
1000000010000000001
1111111111111111111
